-14
15
-8
7
000000000000000000000000000000
111111111111111111111111111110
100000000000000000000000000010
100000000000000000000000000010
100000000000001111111000000010
100000000000001111111000000010
100000000000001111111000000010
100000000000001111111000000010
100000000000000000000000000010
100000001111111000000000000010
100000001111111000000000000010
100000001111111000000000000010
100000001111111000000000000010
100000000000000000000000000010
100000000000000000000000000010
111111111111111111111111111110
